29
15

00000100100010301000100100000
01010101101001010010110101010
00010001001100000110010001000
01110101000100100100010101110
00000100010101010101000100000
10011101010000000001010111001
01000001010101010101010000010
30011011000000200000011011003
01000001010101010101010000010
10011101010000000001010111001
00000100010101010101000100000
01110101000100100100010101110
00010001001100000110010001000
01010101101001010010110101010
00000100100010301000100100000